[level1]
name="the lame one"
tile_size=20
width=10
height=9
data=
1,1,1,1,1,1,1,1,1,1,
1,0,0,0,0,0,0,0,0,1,
1,0,1,1,0,0,1,1,0,1,
1,0,0,0,0,0,1,1,0,1,
1,0,0,0,0,0,0,0,0,1,
1,0,0,0,1,0,0,0,0,1,
1,0,0,0,1,0,0,1,0,1,
1,0,0,0,0,0,0,0,0,1,
1,1,1,1,1,1,1,1,1,1
start_position=1,1,33.33
